Juneunit - Juneunit

Mason Bee - Play Flights

Men With Secrets - Psycho Romance

SUDS - Sick Universe Demands Sharing

Pulse Emitter - Swirlings

Recondite - Dwell

Imre Kiss - Oimachi EP

Night Gestalt - Sudden Rituals Vol. 1

Roll The Dice - Assimilarity

Earth Trax - LP1

Gigi Masin - Calypso

SUDS - Sick Universe Demands Sharing

Zopelar - Joy of missing out

Quaid - Dreem Static

36 - Revisionist History

Fluxion - Perspectives

Ital Tek - Outland

LF58 - Alterazione

Luke Slater - Berghain Funfzehn

The Fear Ratio - They Can't be Saved

Ocoeur - Everything

Daniel Avery & Alessandro Cortini - Illusion of time

Aquarian - The Snake that Eats Itself

Rival Consoles - Articulation

36Â  - Wave Variations

Yamaneko - Spa Commissions 2

Dallas Acid - The Spiral Ambience

Prins Thomas - Ambitions

Arms and Sleepers - Memory Loops

Ital Tek - Dream Boundary

Imaginary Softwoods - Annual Flowers in Color

Shinichi Atobe - Yes

Pole - Fading

Earthen Sea - Quiet Pools

Hiroshi Yoshimura - Green

Brian Eno - Film Music 1976-2020

Remember - Four Shots of Green Stone

Blue States - Trinity Tapes

Akasha System - Geomind

Locust - The Plaintive

Sebastian Mullaert - Natthall

Aleksi Perala - Oscillation Part 1

Monolake - Archaeopteryx

Craven Faults - Enclosures

Trees Speak - Ohms

Pub - Do you ever regret pantomime?

Virtual Dreams - Ambient Explorations in The House & Techno Age

Kuedo - The Sprawl

Forest Drive West - Parallel Space EP

Sibling - Sounds Of Silence

Belbury Poly - The Gone Away

The Detroit Escalator Co. - Soundtrack 313

Martin Brugger - Music for Video Stores

Valium Aggelein - Blakc Moon

Vril & Rodhad - Out of Place Artefacts

FSOL - Cascade 2020