Madlib - Sound Ancestors

Galcher Lustwerk - Information (Redacted)

Arovane - Wirkung

Cristian Vogel - Rebirth of Wonky

Flying Lotus - Yasuke

Daniel Avery - Together in static

Moby - Reprise

Loscil - Clara

XYR - Waves Tapes

Kaidi Tatham - An insight to all minds

Lawrence - Birds on the playground

Andy Stott - Never the right time

Not Waving - Eyes of fate

Steve Moore - Analog Sensitivity

Skee Mask - Pool

Kelpe - Kyverdale Road

Brendon Moeller - Resonance

Plant43 - Unknown Structure

Inigo Kennedy - Recovery Mode

Upper Class - Faster Than Life

Comit - An Ocean of Thoughts

Function - Awakening from the Illusory Self

HTRK - Rhinestones

Mint Huus - Odd Radio Circles

Sansibar - Sans Musique

Ricardo Donoso - Progress Trap

Pye Corner Audio - Entangled Routes

Arovane - Reihen

uZiq - Secret Garden

36 - Weaponised Serenity

58918012 - Fog Echoes

VC-118A - Spiritual Machines

Ocoeur - Connections

Fluxion - Parallel Moves

Byron the Aquarius - The New Beginning

Studio Kosmische - Kosmische Vol. 2

Sky H1 - Azure

JakoJako & Rodhad - In Vere