Tour-Maubourg - Woodfloor Dubs

Galcher Lustwerk - Information (Redacted)

Deadbeat - Root, Stalk, Leaf and Bloom

Biosphere - Shortwave Memories

Silicon Scally - Field Lines

Forest Drive West - Recursion EP

John Tejada - Sleepwalker

Walton - Maisie by the Sea

Carmen Villain - Only Love From Now On

Plastikman - Consumed In Key

The Smile - A Light for Attracting Attention

Imaginary Softwoods - So Extra Bronze Lamp

Pan-American - The Patience Fader

Unkle - Ronin I (Instrumentals)

No Moon - Spins, Parities, & Multipolarities

Silicon Scally - Field Lines

Parc - Wave Irridiscence

Tobias Freund - Hypertext

Farben - Textstar remaster

Rekab - Lost in wires

Rekab - Subtle Beginnings

Mr. Fingers - Around the Sun pt.1

JakoJako - In Vere

XYR - Aquarealm

Solar Fields - Altered

SND & RTN - Chain Reaction EP

Acronym - Millennial Lowlife

Quaid - The algorithm don't like my freek

Tr One - From the studio of

Kuedo - Infinite Window

36 - Stasis Sounds for Long-Distance Space Travel II

36 - Colours in the dark

Al Cisneros - Sinai Dub Box

Kangding Ray - Ultrachroma

SND & RTN - Chain Reaction EP

Pole - Tempus

Vril & Rodhad - Out of Place Artefacts II

Daniel Avery - Ultra Truth

Deepchord - Functional Designs

Artefakt - Brain Dripper EP

Nils Frahm - Music for Animals

Rival Consoles - Now Is

Steffi - The Red Hunter

Biosphere - Substrata (Alternative Versions)

Lord of the isles - Subtle thoughts

Gigi Masin - Vahine

Clark - 05-10

Faserklang - Nu Ways

HKE & Zomby - HKE X ZOMBY

Konduku - Mantis 0910

Canerib Morse - The Truth Is

Blood Incantation - Timewave Zero