Loscil and Lawrence English - Colours of Air

Kosmischer Laufer - The Secret Cosmic Music of the East German Olympic PRogram Vol. 5

Strategy - Graffiti in space

Yugen Disciple - Ancestor Node

Fred P - Message to the universe

Gaia - Selected Ambient & Downtempo Works

uZiq - 1977

Akasha System - Ancient Path Complete

Maara - The ancient truth

Scotch Rolex and Shackleton - Death by Tickling

Vril - Animist

Roman Ridder & Faserklang - Nachtaktiv

Anthony Naples - Orbs

Bochum Welt - Seafire

North Americans - Long Cool World

John Beltran - Serendipia

Galcher Lustwerk - Lustwerk II

Huerta - TV Slang

Wata Igarashi - Agartha 2023

Tim Hecker - No Highs

Surgeon - Crash Recoil

Aphex Twin - Blackbox Life Recorder

Purple Decades - Journey Test

Kassem Mosse - Workshop 32

Ebende - Alien

Ebende - By Your Side

Jeff Mills - X-Ray Zulu

Shackleton - The Scandal of Time

Credit 00 - Midnightlife Crisis

Pachyman - Switched-On

Biosphere - Inland Delta

36 - Ablyss

Kelpe - Pre-Sea Recordings

KWC92 - Dreamin of a vacation

Dialog - DOT1

NO AI - The Lofi Experiment

VC-118A - Waves of Change

Suburban Knight - Hi8tus

Dregs - Dregs