Donato Dozzy - Magda

TopSide - 90s Video Game Sounds

Dopplereffekt - Infinite Tetraspace

Dialog - Dot 1 + Dot  2 + Dot 3

Pye Corner Audio - The Endless Echo

Khruangbin - A La Sala

Badbadnotgood - Slow Burn

Loscil - Umbel

KMRU - Disconnect

Pjusk - Sekvenser

Suss - Birds & Beasts

Gunjack - Mayhem in Minneapolis

Sub Basics - Retrace

Not Waving - Infinite Light

Total Blue - Total Blue

Artefakt - Floodplain

Seefeel - Everything Squared

The Bug - Machine

Hang Massive - Wisdom in the roots

Wooldand Meditation - III

Monolake - Studio

Frank & Tony - Ethos

Plant43 - The Sentient City Awakens

Pan American - Reverberations

Disasterpiece - Standstill

One Million Eyes - Polaris

Moin - You Never End

Virtual Dreams II - Ambient Explorations in the House & Techno Age

Chuck Johnson - Sun Glories

Fred P - Above The City

Earthen Sea - Recollection

Murcof - Twin Color Vol 1

Fennesz - Mosaic

The Balloonisst - A Quiet Day

Hollie Kenniff - For Forever

Wound - Plasticene

Royksopp - Nebulous Nights

Priori - This but more

Seefeel - Squared Roots

Faux Tapes - Dive

Aphex - Music from the merch desk

Flying Lotus - Spirit Box

Four Tet - Three

Nonkeen - All Good?

Shinichi Atobe - Discipline

XYR - Middle of nowhere

Alva Noto - Xerrox Vol 5

Brendon Moeller - Mirage

Adam Wiltzie - Eleven Fugues

Helena Basilova - Homage to Ryuichi Sakamoto

Grand River & Abul Mogard - In uno spazio immenso

ReKab - Diverse Pathways

Ben Klock - Layer One

Aphex Twin - Music from the merch desk

The Balloonist - A Quiet Day

Brendon Moeller - Mirage