Jonny Nash - Once was ours forever

Sync24 - Hope

Immediate Proximity - Improx 4

Ben Frost - Under Certain Light

Deenamic - Dub Reflections

De-Phazz - Luck You!

Biosphere - The Way of Time

Calibre - Little Foot

Aleksi Perälä - Grace 9

Space Dimension Controller - Six Beginnings

Moon Mullins - Hotel Paradiso

Forest Swords - Bolted (Deconstructed)

Lake Haze - Geonomic Fusion

Djrum - Under Tangled Silence

Anthony Naples - Scanners

Loscil - Lake FIre

DeepChord - Vantage Isle (Remastered)

Martin Glass - The Interstellar Music of Martin Glass

Phaeleh - Dark Sky

Sandwell District - End Beginnings

Medusozoa Vol. III

Strategy - A Cooler World

Barker - Stochastic Drift

ReKab - Concept

Mark Van Hoen - Multiplex

Pan American - New World Lonely Ride

Bvdub - 13

Brendon Moeller - Peacemaker

Lawrence English - Even the horizon knows its bounds

SND & RTN - Realm of shadows

Polynation - Bloom

Mad Keys - A few more ideas

Pye Corner Audio - Where things are hollow

海洋探査 - Fishfish

